1111131111
1000000001
1111101111
1101101001
1000001011
1101101001
1111101011
1100000001
1001101111
1111121111
