1111111131
1110101101
1100100001
1110111101
1000000001
1101101011
1000101011
1111000001
1000011011
1211111111
