1111131111
1110101101
1000100001
1110111101
1000000001
1101111111
1000001011
1111000001
1111011011
1111211111
