1111111131
1000000001
1101111111
1101011011
1000000011
1111111001
1000000011
1101111101
1000000001
1211111111
