1111111131
1000000001
1101101111
1101111011
1001000011
1101111001
1000001011
1101111011
1000000001
1111111121
